The Red Ones Are Bad
01 11 11 11 06 11 11 11 01
11 11 11 11 11 11 11 11 11
11 08 11 11 06 11 11 08 11
11 11 11 11 11 11 11 11 11
11 11 11 11 08 11 11 11 11
11 11 11 11 11 11 11 11 11
11 02 11 11 11 11 11 06 11
11 11 11 11 07 11 11 11 11
11 11 11 11 11 11 11 11 11
08 11 11 01 11 03 11 11 08
