Pyramid

12 12 12 12 12 12 08 12 12
12 08 12 12 12 12 12 12 12
12 12 12 12 12 12 12 12 12
12 12 12 12 12 12 12 12 08
08 12 12 12 07 12 12 12 12
12 12 12 07 07 07 12 12 12
12 12 07 04 12 04 07 12 12
12 07 06 12 07 12 06 07 12
07 03 12 12 04 12 12 03 07
01 15 15 12 03 12 15 15 01
