Easy Start
11 12 13 11 08 13 11 12 13
12 13 11 12 07 11 12 13 11
13 11 12 13 11 12 13 11 12
11 12 13 11 07 13 11 12 13
12 13 11 12 13 11 12 13 11
13 11 12 13 07 12 13 11 12
11 12 13 11 12 13 11 12 13
12 13 11 12 07 11 12 13 11
13 11 12 13 11 12 13 11 12
01 12 13 11 07 13 11 12 03
