The Wall
15 15 15 15 08 15 15 15 15
15 15 15 15 15 15 15 15 15
04 15 15 15 15 15 15 15 04
15 15 02 15 15 15 02 15 15
06 15 15 15 15 15 15 15 06
15 15 15 07 15 07 15 15 15
01 15 15 15 15 15 15 15 01
03 15 15 15 15 15 15 15 03
15 15 15 15 15 15 15 15 15
00 15 00 15 00 15 00 15 00
