Minefield

12 12 08 12 12 08 12 12 08
12 15 12 12 15 12 12 15 12
15 12 12 15 12 12 15 12 12
12 12 15 12 12 15 12 12 15
12 15 12 12 15 12 12 15 12
15 12 12 15 12 12 15 12 12
01 12 03 12 06 12 07 12 07
12 12 12 12 12 12 12 12 12
12 04 12 02 12 06 12 04 12
12 12 08 12 12 12 08 12 12
