Fun Times

13 13 08 13 13 13 08 13 13
13 13 13 13 13 13 13 13 13
13 13 07 13 13 13 07 13 13
13 13 13 13 13 13 13 13 13
13 13 13 13 13 13 13 13 13
13 13 13 13 13 13 13 13 13
13 13 13 13 13 13 13 13 13
13 13 13 13 13 13 13 13 13
13 13 13 13 03 13 13 13 13
01 13 08 13 07 13 08 13 06