Triple Threat

07 07 07 07 08 07 07 07 07 
07 07 07 07 07 07 07 07 07 
07 07 06 07 08 07 06 07 07 
07 07 07 07 07 07 07 07 07 
07 07 07 07 08 07 07 07 07 
07 07 07 07 07 07 07 07 07 
07 07 06 07 08 07 06 07 07 
07 07 07 07 07 07 07 07 07 
07 07 07 07 08 07 07 07 07 
07 07 07 07 01 07 07 07 07 