Impossible

02 00 04 00 08 00 04 00 02
13 13 13 13 13 13 13 13 13
13 13 13 13 13 13 13 13 13
13 13 13 13 13 13 13 13 13
13 13 13 13 07 13 13 13 13
13 02 13 13 13 13 13 02 13
13 13 13 13 13 13 13 13 13
13 04 13 13 13 13 13 04 13
13 13 13 13 13 13 13 13 13
06 06 06 01 07 01 06 06 06

